GEEEEEEEEE
PEEEEEEEEE
PEEEEEEEEE
PPEEEEEEEE
EPEEEEEEEE
EPEEEEEEEE
EPEEEEEEEE
EPEEEEEEEE
EPPPPPEEEE
EEEEEPPPSE