GPPPPPEEEE
PEEEEPEEEE
PEEEEPEEEE
PPEEEEEEEE
EPEEEEEEEE
EPEEEEEEEE
EPEEEEEEEE
EPEEEEEEEE
EPPPPPEEEE
EEEEEPPPSE